222222222222222222222
210000000000000000002
202220202222020222202
202020200202020200202
202220202222020222202
200020200000000200002
200020222000333200002
200022000200300320002
200002222200300300002
200002000200300300002
200002000200333000002
100000000200000000002
200000000202000000002
200000444200555000002
200004000400500500002
200004444400555550002
200004000400000500002
200004000400000500002
200E00000200000000P02
200000000202000000002
222222222222222222222
