222222222222222222222
200000000000000000002
202220000222000022202
202020000202000020202
202220000222000022202
200000000000000000002
200000222000333000002
200002000200300300002
200002222200300300002
200002000200300300002
200002000200333000002
1E00000000000000000P2
200000000000000000002
200000444000555000002
200004000400500500002
200004444400555550002
200004000400000500002
200004000400000500002
200000000000000000002
266666666666666666662
222222222222222222222
