111111111111111111111
100000000000000000001
101110000111000011101
101010000101000010101
101110000111000011101
100000000000000000001
100000222000333000001
100002000200300300001
100002222200300300001
100002000200300300001
100002000200333000001
1000000P0000000000001
100000000000000000001
100000444000555000001
100004000400500500001
100004444400555550001
100004000400000500001
1000040B0400000500001
100000000000000000001
166666666666666666661
111111111111111111111
